11111111111111111111
11000000011000000011
11211011011011011211
11000000000000000011
11011010111101011011
11000010000001000011
11111010133101011111
11000000133100000011
11111010111101011111
11000010000001000011
11011010111101011011
11000000000000000011
11211011011011011211
11000000011000000011
11111111111111111111