111111111111111
100002222200001
101212121212101
102222222222201
101212121212101
122222222222221
121212121212121
122222222222221
121212121212121
122222222222221
101212121212101
102222222222201
101212121212101
100002222200001
111111111111111